1 1
1 1 1 1 1 1 1 1 1 1 1 1 1 
1 O 1 O 1 O 1 O 1 O 1 O 1 
1 0 0 1 0 0 0 0 0 1 0 0 1 
1 0 1 0 1 0 1 B 1 0 1 0 1 
1 1 1 1 1 1 1 1 1 1 1 1 1 
